Alice,Bob,Charlie,David,Eve,Frank,Grace,Henry,Ivy,Jack,Kate,Liam,Mia,Noah,Olivia,Peter,Quinn,Rachel,Sam,Tina
0 -1 2 1 6 7 8 9 5 4 10 12 15 14 13 16 18 19 17 -1
-1 0 6 1 4 5 11 7 8 9 -1 12 10 13 16 15 19 18 17 2
2 6 0 4 9 8 10 14 13 1 5 7 11 12 16 17 3 15 18 19
1 1 4 0 5 6 7 12 13 14 15 16 2 3 11 19 9 10 18 17
6 4 9 5 0 7 3 1 14 11 15 12 13 19 16 10 18 17 2 8
7 5 8 6 7 0 2 1 11 10 14 15 16 3 13 9 17 12 4 18
8 11 10 7 3 2 0 4 12 15 13 14 1 5 6 19 18 16 9 17
9 7 14 12 1 1 4 0 2 3 16 19 10 17 13 6 8 15 11 5
5 8 13 13 14 11 12 2 0 6 9 17 19 1 4 10 15 16 3 7
4 9 1 14 11 10 15 3 6 0 2 7 18 8 13 19 12 5 17 18
10 5 11 15 2 9 14 16 17 13 0 3 8 19 12 4 6 7 1 -1
12 12 7 16 13 15 19 19 18 8 3 0 4 5 9 2 10 1 11 6
15 10 11 2 19 16 18 10 1 19 8 4 0 3 12 9 13 7 5 17
14 13 12 3 2 3 16 17 4 12 19 5 3 0 11 1 7 8 18 6
13 16 16 11 13 13 17 13 10 4 12 9 12 11 0 8 14 19 5 3
16 15 17 19 16 9 6 6 15 6 2 2 9 1 8 0 1 14 11 10
18 19 3 9 10 17 8 8 16 7 10 10 13 7 14 1 0 15 12 6
19 18 15 10 18 12 16 15 3 5 1 1 7 8 19 14 15 0 5 8
17 17 18 18 17 4 9 11 7 17 -1 11 5 18 5 11 12 5 0 4
-1 2 19 17 8 18 17 5 6 18 11 6 17 6 3 -1 6 8 4 0